%%%%%%%
% P   %
%     %
%  .  %
%     %
%. GG %
%%%%%%%
